##O##
OOOOO
##E##
=
##O##
OOOOO
#OEO#
=
##O##
OOOOO
O#O#O
#OEO#
=
###O###
AC#O#CA
CDOOODC
#OOEOO#
=