##OOO##
#OOOOO#
OOOOOO#
#OOOOO#
#OOOO##
=
#OOOOO#
#OOOOO#
OOOOOOO
#OOOOO#
#OOOOO#
=