#OOOOOOO#
OOOOOOOOO
OOOOOOOOO
OOOOOOOOO
OOOOOOOOO
OOOOOOOOO
#OOOOOOO#
=
#O#OOOOO#
OOOOOOOOO
OO#OOOOOO
OO#OOOOOO
OO#OOOOOO
OOOOOOOOO
#O#OOOOO#
=
#O#OOOOO#
OOOOOOOOO
OO#OOOOOO
O###OOOOO
OO#OOOOOO
OOOOOOOOO
#O#OOOOO#
=
#O#OOOOO#
OOOOOOO#O
OO#OOOOOO
O###OOOOO
OO#OOOOOO
OOOOOOO#O
#O#OOOOO#
=
#O#OOOOO#
OOOOOOO#O
OO#OOO#OO
O#OOOOOOO
OO#OOO#OO
OOOOOOO#O
#O#OOOOO#
=
#O#OOOOO#
OOOOOOO#O
OO#OOO#OO
OOO#OOOOO
OO#OOO#OO
OOOOOOO#O
#O#OOOOO#
=
#O#OO#OO#
OOOOOOO#O
OO#OOOOOO
OOO#OOOOO
OO#OOOOOO
OOOOOOO#O
#O#OO#OO#
=
#O#OO#OO#
OOOO#OO#O
OO#OOOOOO
OOO#OO#OO
OO#OOOOOO
OOOO#OO#O
#O#OO#OO#
=
#OOOO#OOO
OOOO#OO#O
OO#OOOOOO
OOO#OO#OO
OO#OOOOOO
OOOO#OO#O
#OOOO#OOO
=
#OOOO#OOO
O#OO#OO#O
OO#OOOOOO
OOOOOO#OO
OO#OOOOOO
O#OO#OO#O
#OOOO#OOO
=
#OOOOOOO#
OOOOOOOOO
OOOO#OOOO
OOO###OOO
OOOO#OOOO
OOOOOOOOO
#OOOOOOO#
=
#OOOOOOO#
OOOOOOO#O
OOOO#OOOO
OOO###OOO
OOOO#OOOO
OOOOOOO#O
#OOOOOOO#
=
#OOOOOOO#
O#OOOOO#O
OOOO#OOOO
OOO###OOO
OOOO#OOOO
O#OOOOO#O
#OOOOOOO#
=
#OOOOOOO#
O#OO#OO#O
OOOO#OOOO
OO###OOOO
OOOO#OOOO
O#OO#OO#O
#OOOOOOO#
=
#OOOOOOO#
O#OO#OO#O
OOOOOOOOO
OO#OOO#OO
OOOOOOOOO
O#OO#OO#O
#OOOOOOO#
=
OOOOOOOOO
O#OO#OO#O
OOOOOOOOO
OO#OOO#OO
OOOOOOOOO
O#OO#OO#O
OOOOOOOOO
=
OOOOOOOOO
O#OO#OO#O
OOOOOOOOO
O#OOOOO#O
OOOOOOOOO
O#OO#OO#O
OOOOOOOOO
=
OOOO#OOOO
O#OO#OO#O
OOOOOOOOO
O#OOOOO#O
OOOOOOOOO
O#OO#OO#O
OOOO#OOOO
=
OOOO#OOOO
O#OO#OO#O
OOOOOOOOO
O#OO#OO#O
OOOOOOOOO
O#OO#OO#O
OOOO#OOOO
=
OOOO#OOOO
#OOO#OOO#
OOOOOOOOO
O#OO#OO#O
OOOOOOOOO
#OOO#OOO#
OOOO#OOOO
=
OOOO#OOOO
#OOO#OOO#
OOOOOOOOO
O#OO#OOO#
OOOOOOOOO
#OOO#OOO#
OOOO#OOOO
=
OOOOOOOOO
#OOO#OOO#
OOOOOOOOO
OO#O#O#OO
OOOOOOOOO
#OOO#OOO#
OOOOOOOOO
=
OOOOOOOOO
#OOO#OOO#
OOO#OOOOO
OO#OOO#OO
OOO#OOOOO
#OOO#OOO#
OOOOOOOOO
=
OOOOOOOOO
#OOO#OOO#
OOO#O#OOO
OO#OOOOOO
OOO#O#OOO
#OOO#OOO#
OOOOOOOOO
=
OOOOO#OOO
#OOO#OOO#
OOO#O#OOO
OOOOOOOOO
OOO#O#OOO
#OOO#OOO#
OOOOO#OOO
=
OOOOO#OOO
#OOO#OOO#
OOO#OOOOO
O#OOOOO#O
OOO#OOOOO
#OOO#OOO#
OOOOO#OOO
=



























